11111111111111111111
100000000C0000000001
100111C0000111000001
10000100000100000001
100001111P01000000C1
1000010000C111E11111
1110110000010000C001
10C00010001110000001
10000000000111111001
1C000001000000000C01
11111111111111111111
