11111111111111111111
1P00000000C000000C01
100111C0000111000001
10000100000100000001
1000011110010000C001
100001C0000111111111
111E11000C01000000C1
10000010001110000001
10000000000111111001
1C00C001000000C00001
11111111111111111111
