11111111111111111111
100000000000000E0001
100000C0000000000001
10000000000000000001
10000000000000000001
10000000000P00000001
11111111111111111111
