11111111111111111111
10000100000100000001
10C00100000010111111
10000000000010100101
1000100000000C000101
10001111111000000001
10011000000000011111
100C0000001111110001
100110000C0000010001
10001000111111110001
10001000000000P00001
10C01000C0000E00C001
11111111111111111111
