11111111111111111111
100000000C0000000001
100111C0000111000001
100001000P0100000001
100001111001000000C1
1000010000C111111111
1110110000010000C011
10C00010001110000001
1000E000000111111001
1C000001000000000C01
11111111111111111111
