1111111
1CCPCC1
1CE0CC1
1CCCCC1
1111111
