11111111111111111111
100Z00000C0000000001
100111C000011100Z001
100001000P0100000001
100001111001000000C1
100Z010000C111111111
1110110000010000C011
10C00010001110000001
1000E000000111111001
1C000Z01000000000C01
11111111111111111111
